NO ./assets/backroom-north.xpm
SO ./assets/backroom-south.xpm
WE ./assets/backroom-west.xpm
EA ./assets/backroom-east.xpm

F 176,178,50
C 176,178,50

11111111111111111111
10001000000000010001
10001011000011010001
10001011000011010001
11011000000000011011
10000000000000000001
11011000000000011011
10001011000011010001
10001011000011010001
10001000000000010001
10001000000000010001
10001011000011010001
10001011000011010001
11011000000000011011
10000000000000000001
11011000000000011011
10001011000011010001
1000101100001101001
10001000000000010001
11111111111111111111
