NO ./assets/creeper.xpm
SO ./assets/creeper.xpm
WE ./assets/creeper.xpm
EA ./assets/creeper.xpm

F 0,0,0
C 204,153,0

11111111111111111111
10001000000000010001
10001011000011010001
10001011000011010001
11011000000000011011
10000000000000000001
11011000000000011011
10001011000011010001
10001011000011010001
10001000000000010001
10001000000000010001
10001011000011010001
10001011000011010001
11011000000000011011
10000000000000000001
11011000000000011011
10001011000011010001
10001011000011010N01
10001000000000010001
11111111111111111111
